,area,total,men,women,household,date,date1,year
125,生野,142311,67896,74415,59742,2001-03-01,03-01,2001
126,旭,98809,47674,51135,44219,2001-03-01,03-01,2001
127,城東,157885,75995,81890,68401,2001-03-01,03-01,2001
128,鶴見,102687,50318,52369,39313,2001-03-01,03-01,2001
129,阿倍野,104201,48377,55824,45579,2001-03-01,03-01,2001
130,住吉,160912,76301,84611,72209,2001-03-01,03-01,2001
131,東住吉,139006,66198,72808,60197,2001-03-01,03-01,2001
132,平野,201807,97436,104371,81142,2001-03-01,03-01,2001
133,西成,136648,78487,58161,75541,2001-03-01,03-01,2001
134,東成,78582,37709,40873,34342,2001-03-01,03-01,2001
135,住之江,135205,65604,69601,54367,2001-03-01,03-01,2001
136,東淀川,183201,91401,91800,88241,2001-03-01,03-01,2001
137,淀川,163303,81509,81794,80322,2001-03-01,03-01,2001
138,西淀川,92659,46211,46448,38729,2001-03-01,03-01,2001
139,北,92266,44586,47680,47511,2001-03-01,03-01,2001
140,都島,97401,47768,49633,43339,2001-03-01,03-01,2001
141,福島,56115,26700,29415,25410,2001-03-01,03-01,2001
142,此花,64914,32069,32845,27153,2001-03-01,03-01,2001
143,中央,55744,25833,29911,29776,2001-03-01,03-01,2001
144,大阪市,2598864,1272586,1326278,1172259,2001-03-01,03-01,2001
145,港,87000,42957,44043,37852,2001-03-01,03-01,2001
146,大正,74779,37253,37526,30856,2001-03-01,03-01,2001
147,天王寺,59019,27698,31321,27036,2001-03-01,03-01,2001
148,浪速,50485,26221,24264,29950,2001-03-01,03-01,2001
149,西,63925,30385,33540,31032,2001-03-01,03-01,2001
150,生野,141092,67318,73774,59888,2002-03-01,03-01,2002
151,旭,98226,47299,50927,44052,2002-03-01,03-01,2002
152,城東,158602,76238,82364,69271,2002-03-01,03-01,2002
153,鶴見,103729,50690,53039,40015,2002-03-01,03-01,2002
154,阿倍野,105041,48780,56261,46222,2002-03-01,03-01,2002
155,住吉,160842,76139,84703,72676,2002-03-01,03-01,2002
156,東住吉,138447,65872,72575,60437,2002-03-01,03-01,2002
157,平野,202215,97408,104807,82073,2002-03-01,03-01,2002
158,西成,136777,78962,57815,77227,2002-03-01,03-01,2002
159,東成,78498,37596,40902,34760,2002-03-01,03-01,2002
160,住之江,134371,65085,69286,54471,2002-03-01,03-01,2002
161,東淀川,182821,91189,91632,89005,2002-03-01,03-01,2002
162,淀川,165367,82379,82988,82145,2002-03-01,03-01,2002
163,西淀川,93560,46582,46978,39259,2002-03-01,03-01,2002
164,北,93435,45129,48306,48804,2002-03-01,03-01,2002
165,都島,98350,48161,50189,44256,2002-03-01,03-01,2002
166,福島,56543,26881,29662,26103,2002-03-01,03-01,2002
167,此花,64899,31944,32955,27377,2002-03-01,03-01,2002
168,中央,58522,27119,31403,32139,2002-03-01,03-01,2002
169,大阪市,2608804,1276058,1332746,1190959,2002-03-01,03-01,2002
170,港,86017,42391,43626,37910,2002-03-01,03-01,2002
171,大正,74011,36798,37213,30799,2002-03-01,03-01,2002
172,天王寺,59932,28068,31864,27636,2002-03-01,03-01,2002
173,浪速,51556,26685,24871,31175,2002-03-01,03-01,2002
174,西,65951,31345,34606,33259,2002-03-01,03-01,2002
175,生野,140608,67090,73518,60386,2003-03-01,03-01,2003
176,旭,97653,46931,50722,44005,2003-03-01,03-01,2003
177,城東,158856,76258,82598,69608,2003-03-01,03-01,2003
178,鶴見,103963,50665,53298,40378,2003-03-01,03-01,2003
179,阿倍野,105904,49194,56710,46746,2003-03-01,03-01,2003
180,住吉,160676,75932,84744,72823,2003-03-01,03-01,2003
181,東住吉,137587,65404,72183,60486,2003-03-01,03-01,2003
182,平野,201802,96984,104818,82377,2003-03-01,03-01,2003
183,西成,136289,79079,57210,78331,2003-03-01,03-01,2003
184,東成,78501,37525,40976,35163,2003-03-01,03-01,2003
185,住之江,133290,64448,68842,54692,2003-03-01,03-01,2003
186,東淀川,181912,90713,91199,89292,2003-03-01,03-01,2003
187,淀川,166962,83012,83950,83300,2003-03-01,03-01,2003
188,西淀川,94255,46849,47406,39758,2003-03-01,03-01,2003
189,北,95103,45913,49190,50381,2003-03-01,03-01,2003
190,都島,98682,48251,50431,44900,2003-03-01,03-01,2003
191,福島,57524,27324,30200,27086,2003-03-01,03-01,2003
192,此花,64477,31619,32858,27507,2003-03-01,03-01,2003
193,中央,60099,27848,32251,33998,2003-03-01,03-01,2003
194,大阪市,2613675,1277001,1336674,1205772,2003-03-01,03-01,2003
195,港,85048,41834,43214,37800,2003-03-01,03-01,2003
196,大正,73652,36548,37104,30764,2003-03-01,03-01,2003
197,天王寺,60831,28430,32401,28376,2003-03-01,03-01,2003
198,浪速,52281,26967,25314,32126,2003-03-01,03-01,2003
199,西,67720,32183,35537,35489,2003-03-01,03-01,2003
200,生野,139977,66792,73185,60961,2004-03-01,03-01,2004
201,旭,96701,46381,50320,43798,2004-03-01,03-01,2004
202,城東,159617,76520,83097,70263,2004-03-01,03-01,2004
203,鶴見,105901,51467,54434,41353,2004-03-01,03-01,2004
204,阿倍野,106105,49300,56805,46929,2004-03-01,03-01,2004
205,住吉,160121,75541,84580,72997,2004-03-01,03-01,2004
206,東住吉,136709,64927,71782,60501,2004-03-01,03-01,2004
207,平野,201162,96452,104710,82817,2004-03-01,03-01,2004
208,西成,135596,79073,56523,79297,2004-03-01,03-01,2004
209,東成,78839,37614,41225,35740,2004-03-01,03-01,2004
210,住之江,131816,63623,68193,54558,2004-03-01,03-01,2004
211,東淀川,180341,89908,90433,89041,2004-03-01,03-01,2004
212,淀川,167635,83185,84450,84168,2004-03-01,03-01,2004
213,西淀川,94841,47061,47780,40224,2004-03-01,03-01,2004
214,北,96820,46720,50100,52053,2004-03-01,03-01,2004
215,都島,99062,48364,50698,45459,2004-03-01,03-01,2004
216,福島,58642,27832,30810,27976,2004-03-01,03-01,2004
217,此花,64533,31530,33003,27859,2004-03-01,03-01,2004
218,中央,62500,28958,33542,36129,2004-03-01,03-01,2004
219,大阪市,2618916,1278084,1340832,1220884,2004-03-01,03-01,2004
220,港,83915,41197,42718,37673,2004-03-01,03-01,2004
221,大正,73977,36638,37339,31156,2004-03-01,03-01,2004
222,天王寺,61601,28729,32872,29048,2004-03-01,03-01,2004
223,浪速,52977,27232,25745,32968,2004-03-01,03-01,2004
224,西,69528,33040,36488,37916,2004-03-01,03-01,2004
225,東成,78825,37535,41290,36070,2005-03-01,03-01,2005
226,生野,139061,66358,72703,61302,2005-03-01,03-01,2005
227,旭,95614,45769,49845,43631,2005-03-01,03-01,2005
228,城東,160163,76679,83484,70829,2005-03-01,03-01,2005
229,鶴見,107186,51948,55238,42232,2005-03-01,03-01,2005
230,住之江,131631,63422,68209,55128,2005-03-01,03-01,2005
231,住吉,159351,75050,84301,72965,2005-03-01,03-01,2005
232,東住吉,135207,64156,71051,60105,2005-03-01,03-01,2005
233,平野,200720,96017,104703,83228,2005-03-01,03-01,2005
234,東淀川,179147,89290,89857,89134,2005-03-01,03-01,2005
235,阿倍野,107035,49745,57290,47451,2005-03-01,03-01,2005
236,淀川,167888,83148,84740,84310,2005-03-01,03-01,2005
237,西成,133716,78369,55347,78957,2005-03-01,03-01,2005
238,浪速,53274,27289,25985,33446,2005-03-01,03-01,2005
239,大阪市,2622879,1278390,1344489,1232982,2005-03-01,03-01,2005
240,北,98262,47393,50869,53255,2005-03-01,03-01,2005
241,都島,100062,48778,51284,46278,2005-03-01,03-01,2005
242,福島,59679,28300,31379,28824,2005-03-01,03-01,2005
243,此花,64146,31225,32921,27814,2005-03-01,03-01,2005
244,西淀川,95553,47334,48219,40552,2005-03-01,03-01,2005
245,西,71480,33965,37515,40228,2005-03-01,03-01,2005
246,港,83290,40812,42478,37461,2005-03-01,03-01,2005
247,大正,73540,36350,37190,30925,2005-03-01,03-01,2005
248,天王寺,63086,29360,33726,30221,2005-03-01,03-01,2005
249,中央,64963,30098,34865,38636,2005-03-01,03-01,2005
250,東淀川,177808,88462,89346,89399,2006-03-01,03-01,2006
251,平野,200686,95756,104930,84079,2006-03-01,03-01,2006
252,東住吉,134434,63715,70719,60218,2006-03-01,03-01,2006
253,住吉,159000,74841,84159,73047,2006-03-01,03-01,2006
254,阿倍野,106983,49691,57292,47620,2006-03-01,03-01,2006
255,鶴見,107589,52043,55546,42728,2006-03-01,03-01,2006
256,城東,160796,76868,83928,71584,2006-03-01,03-01,2006
257,旭,94809,45299,49510,43445,2006-03-01,03-01,2006
258,生野,138079,65972,72107,61585,2006-03-01,03-01,2006
259,東成,78959,37582,41377,36464,2006-03-01,03-01,2006
260,西成,131714,77190,54524,78435,2006-03-01,03-01,2006
261,住之江,130377,62674,67703,55019,2006-03-01,03-01,2006
262,淀川,169550,83854,85696,85511,2006-03-01,03-01,2006
263,浪速,54825,28023,26802,34835,2006-03-01,03-01,2006
264,西淀川,95597,47249,48348,40910,2006-03-01,03-01,2006
265,大阪市,2629043,1279416,1349627,1248036,2006-03-01,03-01,2006
266,北,101461,48844,52617,55804,2006-03-01,03-01,2006
267,福島,61213,29017,32196,29875,2006-03-01,03-01,2006
268,此花,63811,31037,32774,27934,2006-03-01,03-01,2006
269,都島,99708,48478,51230,46540,2006-03-01,03-01,2006
270,西,73356,34805,38551,42047,2006-03-01,03-01,2006
271,港,83083,40653,42430,37837,2006-03-01,03-01,2006
272,大正,73019,36022,36997,30993,2006-03-01,03-01,2006
273,天王寺,64598,30048,34550,31227,2006-03-01,03-01,2006
274,中央,67588,31293,36295,40900,2006-03-01,03-01,2006
275,東成,79276,37737,41539,36961,2007-03-01,03-01,2007
276,生野,136752,65345,71407,61781,2007-03-01,03-01,2007
277,旭,94491,45160,49331,43679,2007-03-01,03-01,2007
278,城東,161848,77366,84482,72662,2007-03-01,03-01,2007
279,鶴見,107697,51989,55708,43057,2007-03-01,03-01,2007
280,住之江,129652,62246,67406,55541,2007-03-01,03-01,2007
281,住吉,157996,74320,83676,73113,2007-03-01,03-01,2007
282,東住吉,133971,63498,70473,60437,2007-03-01,03-01,2007
283,平野,200531,95612,104919,84673,2007-03-01,03-01,2007
284,東淀川,177151,88105,89046,90051,2007-03-01,03-01,2007
285,阿倍野,107069,49632,57437,48043,2007-03-01,03-01,2007
286,淀川,170024,84013,86011,86668,2007-03-01,03-01,2007
287,西成,128893,74974,53919,77366,2007-03-01,03-01,2007
288,浪速,56758,28916,27842,36416,2007-03-01,03-01,2007
289,大阪市,2635379,1280487,1354892,1262936,2007-03-01,03-01,2007
290,北,103251,49575,53676,57817,2007-03-01,03-01,2007
291,都島,100769,48884,51885,47376,2007-03-01,03-01,2007
292,福島,61849,29300,32549,30371,2007-03-01,03-01,2007
293,此花,64272,31214,33058,28290,2007-03-01,03-01,2007
294,西淀川,96426,47658,48768,41639,2007-03-01,03-01,2007
295,西,75611,35782,39829,43175,2007-03-01,03-01,2007
296,港,83880,41043,42837,38684,2007-03-01,03-01,2007
297,大正,72329,35605,36724,30972,2007-03-01,03-01,2007
298,天王寺,65076,30159,34917,31483,2007-03-01,03-01,2007
299,中央,69807,32354,37453,42681,2007-03-01,03-01,2007
300,生野,135772,64938,70834,62041,2008-03-01,03-01,2008
301,旭,93987,44923,49064,43834,2008-03-01,03-01,2008
302,城東,163601,78293,85308,73917,2008-03-01,03-01,2008
303,鶴見,109605,52838,56767,44064,2008-03-01,03-01,2008
304,阿倍野,107129,49600,57529,48464,2008-03-01,03-01,2008
305,住吉,157174,73905,83269,73176,2008-03-01,03-01,2008
306,東住吉,133251,63150,70101,60490,2008-03-01,03-01,2008
307,平野,200393,95460,104933,85189,2008-03-01,03-01,2008
308,西成,127154,74533,52621,74233,2008-03-01,03-01,2008
309,東成,79213,37769,41444,37307,2008-03-01,03-01,2008
310,住之江,128643,61768,66875,55794,2008-03-01,03-01,2008
311,東淀川,177277,87949,89328,90867,2008-03-01,03-01,2008
312,淀川,169795,83895,85900,87386,2008-03-01,03-01,2008
313,西淀川,96716,47816,48900,42105,2008-03-01,03-01,2008
314,北,104622,50208,54414,59307,2008-03-01,03-01,2008
315,都島,101881,49320,52561,48438,2008-03-01,03-01,2008
316,福島,63118,29904,33214,31407,2008-03-01,03-01,2008
317,此花,64444,31333,33111,28556,2008-03-01,03-01,2008
318,中央,71818,33511,38307,44170,2008-03-01,03-01,2008
319,大阪市,2643151,1284386,1358765,1275646,2008-03-01,03-01,2008
320,港,84261,41292,42969,39347,2008-03-01,03-01,2008
321,大正,71513,35215,36298,30884,2008-03-01,03-01,2008
322,天王寺,66030,30553,35477,32188,2008-03-01,03-01,2008
323,浪速,58100,29540,28560,38147,2008-03-01,03-01,2008
324,西,77654,36673,40981,44335,2008-03-01,03-01,2008
325,生野,134976,64550,70426,62186,2009-03-01,03-01,2009
326,旭,93262,44587,48675,43781,2009-03-01,03-01,2009
327,城東,165044,79034,86010,75050,2009-03-01,03-01,2009
328,鶴見,110718,53266,57452,44721,2009-03-01,03-01,2009
329,阿倍野,106980,49365,57615,48810,2009-03-01,03-01,2009
330,住吉,156548,73634,82914,73370,2009-03-01,03-01,2009
331,東住吉,132341,62688,69653,60310,2009-03-01,03-01,2009
332,平野,200459,95440,105019,85785,2009-03-01,03-01,2009
333,西成,125273,73567,51706,74465,2009-03-01,03-01,2009
334,東成,79334,37922,41412,37772,2009-03-01,03-01,2009
335,住之江,127635,61244,66391,55845,2009-03-01,03-01,2009
336,東淀川,177185,87607,89578,91447,2009-03-01,03-01,2009
337,淀川,170722,84366,86356,89043,2009-03-01,03-01,2009
338,西淀川,96938,48016,48922,42671,2009-03-01,03-01,2009
339,北,106606,51131,55475,61483,2009-03-01,03-01,2009
340,都島,101638,49168,52470,48929,2009-03-01,03-01,2009
341,福島,64923,30704,34219,32513,2009-03-01,03-01,2009
342,此花,64808,31527,33281,28862,2009-03-01,03-01,2009
343,中央,73889,34499,39390,45623,2009-03-01,03-01,2009
344,大阪市,2651781,1287847,1363934,1292153,2009-03-01,03-01,2009
345,港,84635,41504,43131,39972,2009-03-01,03-01,2009
346,大正,70875,34842,36033,30803,2009-03-01,03-01,2009
347,天王寺,67480,31224,36256,33263,2009-03-01,03-01,2009
348,浪速,59339,30102,29237,39671,2009-03-01,03-01,2009
349,西,80173,37860,42313,45778,2009-03-01,03-01,2009
350,東成,79846,38196,41650,38409,2010-03-01,03-01,2010
351,生野,134379,64386,69993,62644,2010-03-01,03-01,2010
352,旭,92583,44338,48245,43725,2010-03-01,03-01,2010
353,城東,165751,79486,86265,75642,2010-03-01,03-01,2010
354,鶴見,111094,53330,57764,45066,2010-03-01,03-01,2010
355,住之江,127357,61160,66197,56311,2010-03-01,03-01,2010
356,住吉,155879,73435,82444,73666,2010-03-01,03-01,2010
357,東住吉,131232,62213,69019,60111,2010-03-01,03-01,2010
358,平野,200223,95246,104977,86193,2010-03-01,03-01,2010
359,東淀川,176691,87116,89575,91616,2010-03-01,03-01,2010
360,阿倍野,106404,48994,57410,49007,2010-03-01,03-01,2010
361,西成,123348,72579,50769,74648,2010-03-01,03-01,2010
362,淀川,171891,85053,86838,90400,2010-03-01,03-01,2010
363,浪速,60691,30789,29902,41248,2010-03-01,03-01,2010
364,西淀川,97541,48343,49198,43436,2010-03-01,03-01,2010
365,大阪市,2660505,1292259,1368246,1307922,2010-03-01,03-01,2010
366,北,108485,51895,56590,63416,2010-03-01,03-01,2010
367,福島,66267,31366,34901,33568,2010-03-01,03-01,2010
368,此花,65463,31891,33572,29322,2010-03-01,03-01,2010
369,都島,102360,49446,52914,49689,2010-03-01,03-01,2010
370,西,81694,38670,43024,46367,2010-03-01,03-01,2010
371,港,85073,41788,43285,40579,2010-03-01,03-01,2010
372,大正,70080,34430,35650,30691,2010-03-01,03-01,2010
373,天王寺,69356,32084,37272,34344,2010-03-01,03-01,2010
374,中央,76817,36025,40792,47824,2010-03-01,03-01,2010
375,生野,133494,64055,69439,62811,2011-03-01,03-01,2011
376,旭,92378,44233,48145,43775,2011-03-01,03-01,2011
377,城東,165455,79314,86141,75752,2011-03-01,03-01,2011
378,鶴見,111066,53211,57855,45175,2011-03-01,03-01,2011
379,阿倍野,106187,48936,57251,49267,2011-03-01,03-01,2011
380,住吉,155223,72969,82254,73680,2011-03-01,03-01,2011
381,東住吉,130257,61648,68609,59744,2011-03-01,03-01,2011
382,平野,199785,94912,104873,86634,2011-03-01,03-01,2011
383,西成,121037,71219,49818,73961,2011-03-01,03-01,2011
384,東成,80042,38323,41719,38780,2011-03-01,03-01,2011
385,住之江,126955,60889,66066,56546,2011-03-01,03-01,2011
386,東淀川,176215,86699,89516,91562,2011-03-01,03-01,2011
387,淀川,171811,84927,86884,90922,2011-03-01,03-01,2011
388,西淀川,97431,48276,49155,43401,2011-03-01,03-01,2011
389,北,110952,53137,57815,65396,2011-03-01,03-01,2011
390,都島,102852,49680,53172,50066,2011-03-01,03-01,2011
391,福島,67554,31922,35632,34430,2011-03-01,03-01,2011
392,此花,65654,32005,33649,29517,2011-03-01,03-01,2011
393,中央,79108,37065,42043,49378,2011-03-01,03-01,2011
394,大阪市,2663098,1292432,1370666,1316626,2011-03-01,03-01,2011
395,港,84719,41617,43102,40633,2011-03-01,03-01,2011
396,大正,69169,33942,35227,30424,2011-03-01,03-01,2011
397,天王寺,70027,32415,37612,34783,2011-03-01,03-01,2011
398,浪速,62088,31501,30587,42687,2011-03-01,03-01,2011
399,西,83639,39537,44102,47302,2011-03-01,03-01,2011
400,東成,80520,38532,41988,39108,2012-03-01,03-01,2012
401,生野,132459,63621,68838,62979,2012-03-01,03-01,2012
402,旭,91988,44001,47987,43652,2012-03-01,03-01,2012
403,城東,165060,79061,85999,75868,2012-03-01,03-01,2012
404,鶴見,111414,53354,58060,45445,2012-03-01,03-01,2012
405,住之江,126132,60486,65646,56570,2012-03-01,03-01,2012
406,住吉,155126,72861,82265,73274,2012-03-01,03-01,2012
407,東住吉,129160,61124,68036,59193,2012-03-01,03-01,2012
408,平野,199276,94546,104730,87073,2012-03-01,03-01,2012
409,東淀川,176608,86960,89648,92011,2012-03-01,03-01,2012
410,阿倍野,106231,48875,57356,49462,2012-03-01,03-01,2012
411,淀川,172405,85292,87113,91310,2012-03-01,03-01,2012
412,西成,119211,69920,49291,73359,2012-03-01,03-01,2012
413,浪速,63451,32201,31250,43390,2012-03-01,03-01,2012
414,大阪市,2668054,1294003,1374051,1324178,2012-03-01,03-01,2012
415,北,113189,54301,58888,66998,2012-03-01,03-01,2012
416,都島,103021,49697,53324,50267,2012-03-01,03-01,2012
417,福島,69106,32665,36441,35324,2012-03-01,03-01,2012
418,此花,66279,32312,33967,29852,2012-03-01,03-01,2012
419,西淀川,97150,48039,49111,43300,2012-03-01,03-01,2012
420,西,85202,40303,44899,48226,2012-03-01,03-01,2012
421,港,83969,41142,42827,40539,2012-03-01,03-01,2012
422,大正,68292,33454,34838,30183,2012-03-01,03-01,2012
423,天王寺,71395,33109,38286,35558,2012-03-01,03-01,2012
424,中央,81410,38147,43263,51237,2012-03-01,03-01,2012
425,鶴見,111451,53373,58078,45661,2013-03-01,03-01,2013
426,生野,131972,63341,68631,63100,2013-03-01,03-01,2013
427,旭,91944,43970,47974,43679,2013-03-01,03-01,2013
428,城東,164558,78685,85873,75699,2013-03-01,03-01,2013
429,阿倍野,106363,48998,57365,49601,2013-03-01,03-01,2013
430,東成,80569,38597,41972,39297,2013-03-01,03-01,2013
431,住吉,154683,72518,82165,72745,2013-03-01,03-01,2013
432,東住吉,128134,60636,67498,58637,2013-03-01,03-01,2013
433,平野,198940,94377,104563,87586,2013-03-01,03-01,2013
434,西成,117538,68797,48741,72586,2013-03-01,03-01,2013
435,住之江,125603,60279,65324,56866,2013-03-01,03-01,2013
436,東淀川,176854,87048,89806,92203,2013-03-01,03-01,2013
437,西,86677,41004,45673,49003,2013-03-01,03-01,2013
438,西淀川,96631,47663,48968,43196,2013-03-01,03-01,2013
439,北,115162,55329,59833,68472,2013-03-01,03-01,2013
440,都島,104169,50262,53907,50745,2013-03-01,03-01,2013
441,福島,70413,33202,37211,36080,2013-03-01,03-01,2013
442,此花,66574,32461,34113,30072,2013-03-01,03-01,2013
443,中央,83703,39222,44481,52727,2013-03-01,03-01,2013
444,大阪市,2673891,1296296,1377595,1330970,2013-03-01,03-01,2013
445,港,83206,40789,42417,40221,2013-03-01,03-01,2013
446,大正,67336,32913,34423,29833,2013-03-01,03-01,2013
447,天王寺,72869,33890,38979,36354,2013-03-01,03-01,2013
448,浪速,65093,33064,32029,44511,2013-03-01,03-01,2013
449,淀川,173449,85878,87571,92096,2013-03-01,03-01,2013
450,生野,130928,62920,68008,63124,2014-03-01,03-01,2014
451,旭,91770,43876,47894,43579,2014-03-01,03-01,2014
452,城東,163719,78100,85619,75413,2014-03-01,03-01,2014
453,鶴見,111413,53353,58060,45833,2014-03-01,03-01,2014
454,阿倍野,107156,49408,57748,50002,2014-03-01,03-01,2014
455,住吉,154077,72186,81891,72045,2014-03-01,03-01,2014
456,東住吉,127289,60197,67092,58269,2014-03-01,03-01,2014
457,平野,197814,93759,104055,87967,2014-03-01,03-01,2014
458,西成,115247,67189,48058,71424,2014-03-01,03-01,2014
459,東成,80479,38427,42052,39447,2014-03-01,03-01,2014
460,住之江,124513,59755,64758,56880,2014-03-01,03-01,2014
461,東淀川,176146,86710,89436,92083,2014-03-01,03-01,2014
462,淀川,174153,86140,88013,92669,2014-03-01,03-01,2014
463,西淀川,96016,47337,48679,42941,2014-03-01,03-01,2014
464,北,118230,56932,61298,70330,2014-03-01,03-01,2014
465,都島,104264,50249,54015,50937,2014-03-01,03-01,2014
466,福島,71455,33789,37666,36783,2014-03-01,03-01,2014
467,此花,66691,32570,34121,30323,2014-03-01,03-01,2014
468,中央,86718,40574,46144,54805,2014-03-01,03-01,2014
469,大阪市,2675373,1296022,1379351,1336882,2014-03-01,03-01,2014
470,港,82301,40315,41986,40081,2014-03-01,03-01,2014
471,大正,66510,32483,34027,29578,2014-03-01,03-01,2014
472,天王寺,73902,34379,39523,36979,2014-03-01,03-01,2014
473,浪速,66499,33832,32667,45637,2014-03-01,03-01,2014
474,西,88083,41542,46541,49753,2014-03-01,03-01,2014
475,東成,80208,38321,41887,39392,2015-03-01,03-01,2015
476,生野,130272,62746,67526,63370,2015-03-01,03-01,2015
477,旭,91514,43727,47787,43598,2015-03-01,03-01,2015
478,城東,164147,78255,85892,75888,2015-03-01,03-01,2015
479,鶴見,111246,53257,57989,46013,2015-03-01,03-01,2015
480,住之江,123594,59386,64208,56834,2015-03-01,03-01,2015
481,住吉,153898,72010,81888,71689,2015-03-01,03-01,2015
482,東住吉,126586,59804,66782,57879,2015-03-01,03-01,2015
483,平野,197155,93368,103787,88566,2015-03-01,03-01,2015
484,東淀川,175321,86201,89120,92096,2015-03-01,03-01,2015
485,阿倍野,107362,49445,57917,50074,2015-03-01,03-01,2015
486,淀川,174976,86571,88405,93260,2015-03-01,03-01,2015
487,西成,113030,65507,47523,70078,2015-03-01,03-01,2015
488,浪速,68103,34607,33496,46478,2015-03-01,03-01,2015
489,大阪市,2680203,1297433,1382770,1344580,2015-03-01,03-01,2015
490,北,121320,58601,62719,72506,2015-03-01,03-01,2015
491,都島,104487,50379,54108,51202,2015-03-01,03-01,2015
492,福島,71886,33955,37931,37046,2015-03-01,03-01,2015
493,此花,66504,32460,34044,30520,2015-03-01,03-01,2015
494,西淀川,95457,47019,48438,42777,2015-03-01,03-01,2015
495,西,90133,42518,47615,50806,2015-03-01,03-01,2015
496,港,82179,40204,41975,40278,2015-03-01,03-01,2015
497,大正,65574,31986,33588,29360,2015-03-01,03-01,2015
498,天王寺,74968,34886,40082,37555,2015-03-01,03-01,2015
499,中央,90283,42220,48063,57315,2015-03-01,03-01,2015
500,港,81915,41869,40046,40349,2016-03-01,03-01,2016
501,大阪市,2692845,1389722,1303123,1358464,2016-03-01,03-01,2016
502,北,124749,64419,60330,74812,2016-03-01,03-01,2016
503,都島,104831,54251,50580,51743,2016-03-01,03-01,2016
504,福島,72706,38452,34254,37664,2016-03-01,03-01,2016
505,此花,66517,34017,32500,30752,2016-03-01,03-01,2016
506,中央,93765,49926,43839,59559,2016-03-01,03-01,2016
507,西,93275,49309,43966,52708,2016-03-01,03-01,2016
508,大正,64828,33204,31624,29146,2016-03-01,03-01,2016
509,天王寺,76390,40828,35562,38460,2016-03-01,03-01,2016
510,浪速,70648,34762,35886,48172,2016-03-01,03-01,2016
511,淀川,176210,88936,87274,94580,2016-03-01,03-01,2016
512,西淀川,95357,48469,46888,42942,2016-03-01,03-01,2016
513,東成,80507,41980,38527,39713,2016-03-01,03-01,2016
514,西成,111267,46994,64273,68968,2016-03-01,03-01,2016
515,平野,196336,103260,93076,89085,2016-03-01,03-01,2016
516,東住吉,126138,66629,59509,57827,2016-03-01,03-01,2016
517,住吉,153695,81926,71769,71506,2016-03-01,03-01,2016
518,東淀川,175464,89067,86397,92865,2016-03-01,03-01,2016
519,阿倍野,108063,58242,49821,50321,2016-03-01,03-01,2016
520,住之江,122591,63667,58924,56979,2016-03-01,03-01,2016
521,城東,164958,86380,78578,76760,2016-03-01,03-01,2016
522,旭,91442,47814,43628,43573,2016-03-01,03-01,2016
523,生野,129709,67240,62469,63590,2016-03-01,03-01,2016
524,鶴見,111484,58081,53403,46390,2016-03-01,03-01,2016
