,area,total,men,women,household,date,date1,year
25,東成区,78121,37455,40666,32745,1997-03-01,03-01,1997
26,生野区,147314,70422,76892,58674,1997-03-01,03-01,1997
27,旭区,102010,49310,52700,43946,1997-03-01,03-01,1997
28,城東区,155627,75311,80316,64865,1997-03-01,03-01,1997
29,鶴見区,98761,48669,50092,36399,1997-03-01,03-01,1997
30,住之江区,138931,67601,71330,53287,1997-03-01,03-01,1997
31,住吉区,162756,77807,84949,70907,1997-03-01,03-01,1997
32,東住吉区,140980,67472,73508,58849,1997-03-01,03-01,1997
33,平野区,200866,97564,103302,77884,1997-03-01,03-01,1997
34,東淀川区,185205,92960,92245,85718,1997-03-01,03-01,1997
35,阿倍野区,102509,47881,54628,43562,1997-03-01,03-01,1997
36,淀川区,161444,80632,80812,74947,1997-03-01,03-01,1997
37,西成区,140170,79254,60916,74115,1997-03-01,03-01,1997
38,浪速区,49053,25099,23954,26817,1997-03-01,03-01,1997
39,大阪市,2596023,1274144,1321879,1117259,1997-03-01,03-01,1997
40,北区,86701,41539,45162,40890,1997-03-01,03-01,1997
41,都島区,97909,48014,49895,41962,1997-03-01,03-01,1997
42,福島区,54665,26184,28481,23264,1997-03-01,03-01,1997
43,此花区,67495,33756,33739,27277,1997-03-01,03-01,1997
44,西淀川区,90744,45341,45403,36254,1997-03-01,03-01,1997
45,西区,59326,28343,30983,26671,1997-03-01,03-01,1997
46,港区,89015,44285,44730,37129,1997-03-01,03-01,1997
47,大正区,77353,38728,38625,30670,1997-03-01,03-01,1997
48,天王寺区,56047,26080,29967,24272,1997-03-01,03-01,1997
49,中央区,53021,24437,28584,26155,1997-03-01,03-01,1997
50,生野区,145833,69675,76158,58854,1998-03-01,03-01,1998
51,旭区,101048,48831,52217,43989,1998-03-01,03-01,1998
52,城東区,156602,75681,80921,66046,1998-03-01,03-01,1998
53,鶴見区,99517,48979,50538,37204,1998-03-01,03-01,1998
54,阿倍野区,103082,48066,55016,44272,1998-03-01,03-01,1998
55,住吉区,162108,77337,84771,71227,1998-03-01,03-01,1998
56,東住吉区,140245,67035,73210,59179,1998-03-01,03-01,1998
57,平野区,201296,97637,103659,79138,1998-03-01,03-01,1998
58,西成区,138957,78868,60089,74347,1998-03-01,03-01,1998
59,東成区,78340,37578,40762,33380,1998-03-01,03-01,1998
60,住之江区,138153,67184,70969,53745,1998-03-01,03-01,1998
61,東淀川区,184654,92531,92123,86477,1998-03-01,03-01,1998
62,淀川区,160969,80399,80570,75917,1998-03-01,03-01,1998
63,西淀川区,91491,45699,45792,37153,1998-03-01,03-01,1998
64,北区,87580,42063,45517,42222,1998-03-01,03-01,1998
65,都島区,97815,47977,49838,42441,1998-03-01,03-01,1998
66,福島区,54836,26220,28616,23715,1998-03-01,03-01,1998
67,此花区,66449,33134,33315,27077,1998-03-01,03-01,1998
68,中央区,52955,24444,28511,26637,1998-03-01,03-01,1998
69,大阪市,2592477,1271768,1320709,1131037,1998-03-01,03-01,1998
70,港区,88408,43900,44508,37400,1998-03-01,03-01,1998
71,大正区,76534,38273,38261,30771,1998-03-01,03-01,1998
72,天王寺区,56319,26275,30044,24802,1998-03-01,03-01,1998
73,浪速区,49903,25652,24251,27906,1998-03-01,03-01,1998
74,西区,59383,28330,31053,27138,1998-03-01,03-01,1998
75,鶴見区,100383,49343,51040,37893,1999-03-01,03-01,1999
76,東成区,78574,37707,40867,33803,1999-03-01,03-01,1999
77,旭区,100478,48541,51937,44077,1999-03-01,03-01,1999
78,城東区,157157,75848,81309,66922,1999-03-01,03-01,1999
79,阿倍野区,103095,47989,55106,44538,1999-03-01,03-01,1999
80,東淀川区,184876,92489,92387,87254,1999-03-01,03-01,1999
81,住吉区,161600,76935,84665,71310,1999-03-01,03-01,1999
82,東住吉区,140075,66868,73207,59589,1999-03-01,03-01,1999
83,平野区,202079,97879,104200,79868,1999-03-01,03-01,1999
84,西成区,137941,78590,59351,74354,1999-03-01,03-01,1999
85,住之江区,137290,66726,70564,53904,1999-03-01,03-01,1999
86,淀川区,161411,80623,80788,77242,1999-03-01,03-01,1999
87,生野区,144936,69208,75728,59218,1999-03-01,03-01,1999
88,浪速区,49798,25715,24083,28419,1999-03-01,03-01,1999
89,大阪市,2593408,1271560,1321848,1142970,1999-03-01,03-01,1999
90,北区,89133,42914,46219,44093,1999-03-01,03-01,1999
91,都島区,96954,47564,49390,42378,1999-03-01,03-01,1999
92,福島区,54892,26200,28692,24108,1999-03-01,03-01,1999
93,此花区,65961,32792,33169,27058,1999-03-01,03-01,1999
94,西淀川区,91711,45794,45917,37578,1999-03-01,03-01,1999
95,西区,60626,28882,31744,28271,1999-03-01,03-01,1999
96,港区,88267,43748,44519,37618,1999-03-01,03-01,1999
97,大正区,75999,37961,38038,30682,1999-03-01,03-01,1999
98,天王寺区,56756,26549,30207,25345,1999-03-01,03-01,1999
99,中央区,53416,24695,28721,27448,1999-03-01,03-01,1999
100,東成区,78729,37799,40930,34064,2000-03-01,03-01,2000
101,生野区,143362,68418,74944,59272,2000-03-01,03-01,2000
102,旭区,99760,48181,51579,44304,2000-03-01,03-01,2000
103,城東区,156989,75665,81324,67450,2000-03-01,03-01,2000
104,鶴見区,101234,49699,51535,38512,2000-03-01,03-01,2000
105,住吉区,161082,76529,84553,71640,2000-03-01,03-01,2000
106,住之江区,135834,65980,69854,54120,2000-03-01,03-01,2000
107,東住吉区,139909,66703,73206,60055,2000-03-01,03-01,2000
108,平野区,201810,97612,104198,80413,2000-03-01,03-01,2000
109,東淀川区,184049,91922,92127,87670,2000-03-01,03-01,2000
110,阿倍野区,103268,47987,55281,44962,2000-03-01,03-01,2000
111,西成区,136866,78273,58593,74725,2000-03-01,03-01,2000
112,西淀川区,91883,45865,46018,38194,2000-03-01,03-01,2000
113,浪速区,49969,25921,24048,29028,2000-03-01,03-01,2000
114,淀川区,162544,81193,81351,79049,2000-03-01,03-01,2000
115,大阪市,2593851,1271087,1322764,1156867,2000-03-01,03-01,2000
116,北区,90935,43889,47046,46139,2000-03-01,03-01,2000
117,福島区,55293,26345,28948,24620,2000-03-01,03-01,2000
118,此花区,65372,32402,32970,27066,2000-03-01,03-01,2000
119,都島区,97237,47712,49525,42881,2000-03-01,03-01,2000
120,西区,62560,29761,32799,29555,2000-03-01,03-01,2000
121,港区,87392,43233,44159,37693,2000-03-01,03-01,2000
122,大正区,75439,37638,37801,30823,2000-03-01,03-01,2000
123,天王寺区,58039,27220,30819,26249,2000-03-01,03-01,2000
124,中央区,54296,25140,29156,28383,2000-03-01,03-01,2000
125,生野区,142311,67896,74415,59742,2001-03-01,03-01,2001
126,旭区,98809,47674,51135,44219,2001-03-01,03-01,2001
127,城東区,157885,75995,81890,68401,2001-03-01,03-01,2001
128,鶴見区,102687,50318,52369,39313,2001-03-01,03-01,2001
129,阿倍野区,104201,48377,55824,45579,2001-03-01,03-01,2001
130,住吉区,160912,76301,84611,72209,2001-03-01,03-01,2001
131,東住吉区,139006,66198,72808,60197,2001-03-01,03-01,2001
132,平野区,201807,97436,104371,81142,2001-03-01,03-01,2001
133,西成区,136648,78487,58161,75541,2001-03-01,03-01,2001
134,東成区,78582,37709,40873,34342,2001-03-01,03-01,2001
135,住之江区,135205,65604,69601,54367,2001-03-01,03-01,2001
136,東淀川区,183201,91401,91800,88241,2001-03-01,03-01,2001
137,淀川区,163303,81509,81794,80322,2001-03-01,03-01,2001
138,西淀川区,92659,46211,46448,38729,2001-03-01,03-01,2001
139,北区,92266,44586,47680,47511,2001-03-01,03-01,2001
140,都島区,97401,47768,49633,43339,2001-03-01,03-01,2001
141,福島区,56115,26700,29415,25410,2001-03-01,03-01,2001
142,此花区,64914,32069,32845,27153,2001-03-01,03-01,2001
143,中央区,55744,25833,29911,29776,2001-03-01,03-01,2001
144,大阪市,2598864,1272586,1326278,1172259,2001-03-01,03-01,2001
145,港区,87000,42957,44043,37852,2001-03-01,03-01,2001
146,大正区,74779,37253,37526,30856,2001-03-01,03-01,2001
147,天王寺区,59019,27698,31321,27036,2001-03-01,03-01,2001
148,浪速区,50485,26221,24264,29950,2001-03-01,03-01,2001
149,西区,63925,30385,33540,31032,2001-03-01,03-01,2001
150,生野区,141092,67318,73774,59888,2002-03-01,03-01,2002
151,旭区,98226,47299,50927,44052,2002-03-01,03-01,2002
152,城東区,158602,76238,82364,69271,2002-03-01,03-01,2002
153,鶴見区,103729,50690,53039,40015,2002-03-01,03-01,2002
154,阿倍野区,105041,48780,56261,46222,2002-03-01,03-01,2002
155,住吉区,160842,76139,84703,72676,2002-03-01,03-01,2002
156,東住吉区,138447,65872,72575,60437,2002-03-01,03-01,2002
157,平野区,202215,97408,104807,82073,2002-03-01,03-01,2002
158,西成区,136777,78962,57815,77227,2002-03-01,03-01,2002
159,東成区,78498,37596,40902,34760,2002-03-01,03-01,2002
160,住之江区,134371,65085,69286,54471,2002-03-01,03-01,2002
161,東淀川区,182821,91189,91632,89005,2002-03-01,03-01,2002
162,淀川区,165367,82379,82988,82145,2002-03-01,03-01,2002
163,西淀川区,93560,46582,46978,39259,2002-03-01,03-01,2002
164,北区,93435,45129,48306,48804,2002-03-01,03-01,2002
165,都島区,98350,48161,50189,44256,2002-03-01,03-01,2002
166,福島区,56543,26881,29662,26103,2002-03-01,03-01,2002
167,此花区,64899,31944,32955,27377,2002-03-01,03-01,2002
168,中央区,58522,27119,31403,32139,2002-03-01,03-01,2002
169,大阪市,2608804,1276058,1332746,1190959,2002-03-01,03-01,2002
170,港区,86017,42391,43626,37910,2002-03-01,03-01,2002
171,大正区,74011,36798,37213,30799,2002-03-01,03-01,2002
172,天王寺区,59932,28068,31864,27636,2002-03-01,03-01,2002
173,浪速区,51556,26685,24871,31175,2002-03-01,03-01,2002
174,西区,65951,31345,34606,33259,2002-03-01,03-01,2002
175,生野区,140608,67090,73518,60386,2003-03-01,03-01,2003
176,旭区,97653,46931,50722,44005,2003-03-01,03-01,2003
177,城東区,158856,76258,82598,69608,2003-03-01,03-01,2003
178,鶴見区,103963,50665,53298,40378,2003-03-01,03-01,2003
179,阿倍野区,105904,49194,56710,46746,2003-03-01,03-01,2003
180,住吉区,160676,75932,84744,72823,2003-03-01,03-01,2003
181,東住吉区,137587,65404,72183,60486,2003-03-01,03-01,2003
182,平野区,201802,96984,104818,82377,2003-03-01,03-01,2003
183,西成区,136289,79079,57210,78331,2003-03-01,03-01,2003
184,東成区,78501,37525,40976,35163,2003-03-01,03-01,2003
185,住之江区,133290,64448,68842,54692,2003-03-01,03-01,2003
186,東淀川区,181912,90713,91199,89292,2003-03-01,03-01,2003
187,淀川区,166962,83012,83950,83300,2003-03-01,03-01,2003
188,西淀川区,94255,46849,47406,39758,2003-03-01,03-01,2003
189,北区,95103,45913,49190,50381,2003-03-01,03-01,2003
190,都島区,98682,48251,50431,44900,2003-03-01,03-01,2003
191,福島区,57524,27324,30200,27086,2003-03-01,03-01,2003
192,此花区,64477,31619,32858,27507,2003-03-01,03-01,2003
193,中央区,60099,27848,32251,33998,2003-03-01,03-01,2003
194,大阪市,2613675,1277001,1336674,1205772,2003-03-01,03-01,2003
195,港区,85048,41834,43214,37800,2003-03-01,03-01,2003
196,大正区,73652,36548,37104,30764,2003-03-01,03-01,2003
197,天王寺区,60831,28430,32401,28376,2003-03-01,03-01,2003
198,浪速区,52281,26967,25314,32126,2003-03-01,03-01,2003
199,西区,67720,32183,35537,35489,2003-03-01,03-01,2003
200,生野区,139977,66792,73185,60961,2004-03-01,03-01,2004
201,旭区,96701,46381,50320,43798,2004-03-01,03-01,2004
202,城東区,159617,76520,83097,70263,2004-03-01,03-01,2004
203,鶴見区,105901,51467,54434,41353,2004-03-01,03-01,2004
204,阿倍野区,106105,49300,56805,46929,2004-03-01,03-01,2004
205,住吉区,160121,75541,84580,72997,2004-03-01,03-01,2004
206,東住吉区,136709,64927,71782,60501,2004-03-01,03-01,2004
207,平野区,201162,96452,104710,82817,2004-03-01,03-01,2004
208,西成区,135596,79073,56523,79297,2004-03-01,03-01,2004
209,東成区,78839,37614,41225,35740,2004-03-01,03-01,2004
210,住之江区,131816,63623,68193,54558,2004-03-01,03-01,2004
211,東淀川区,180341,89908,90433,89041,2004-03-01,03-01,2004
212,淀川区,167635,83185,84450,84168,2004-03-01,03-01,2004
213,西淀川区,94841,47061,47780,40224,2004-03-01,03-01,2004
214,北区,96820,46720,50100,52053,2004-03-01,03-01,2004
215,都島区,99062,48364,50698,45459,2004-03-01,03-01,2004
216,福島区,58642,27832,30810,27976,2004-03-01,03-01,2004
217,此花区,64533,31530,33003,27859,2004-03-01,03-01,2004
218,中央区,62500,28958,33542,36129,2004-03-01,03-01,2004
219,大阪市,2618916,1278084,1340832,1220884,2004-03-01,03-01,2004
220,港区,83915,41197,42718,37673,2004-03-01,03-01,2004
221,大正区,73977,36638,37339,31156,2004-03-01,03-01,2004
222,天王寺区,61601,28729,32872,29048,2004-03-01,03-01,2004
223,浪速区,52977,27232,25745,32968,2004-03-01,03-01,2004
224,西区,69528,33040,36488,37916,2004-03-01,03-01,2004
225,東成区,78825,37535,41290,36070,2005-03-01,03-01,2005
226,生野区,139061,66358,72703,61302,2005-03-01,03-01,2005
227,旭区,95614,45769,49845,43631,2005-03-01,03-01,2005
228,城東区,160163,76679,83484,70829,2005-03-01,03-01,2005
229,鶴見区,107186,51948,55238,42232,2005-03-01,03-01,2005
230,住之江区,131631,63422,68209,55128,2005-03-01,03-01,2005
231,住吉区,159351,75050,84301,72965,2005-03-01,03-01,2005
232,東住吉区,135207,64156,71051,60105,2005-03-01,03-01,2005
233,平野区,200720,96017,104703,83228,2005-03-01,03-01,2005
234,東淀川区,179147,89290,89857,89134,2005-03-01,03-01,2005
235,阿倍野区,107035,49745,57290,47451,2005-03-01,03-01,2005
236,淀川区,167888,83148,84740,84310,2005-03-01,03-01,2005
237,西成区,133716,78369,55347,78957,2005-03-01,03-01,2005
238,浪速区,53274,27289,25985,33446,2005-03-01,03-01,2005
239,大阪市,2622879,1278390,1344489,1232982,2005-03-01,03-01,2005
240,北区,98262,47393,50869,53255,2005-03-01,03-01,2005
241,都島区,100062,48778,51284,46278,2005-03-01,03-01,2005
242,福島区,59679,28300,31379,28824,2005-03-01,03-01,2005
243,此花区,64146,31225,32921,27814,2005-03-01,03-01,2005
244,西淀川区,95553,47334,48219,40552,2005-03-01,03-01,2005
245,西区,71480,33965,37515,40228,2005-03-01,03-01,2005
246,港区,83290,40812,42478,37461,2005-03-01,03-01,2005
247,大正区,73540,36350,37190,30925,2005-03-01,03-01,2005
248,天王寺区,63086,29360,33726,30221,2005-03-01,03-01,2005
249,中央区,64963,30098,34865,38636,2005-03-01,03-01,2005
250,東淀川区,177808,88462,89346,89399,2006-03-01,03-01,2006
251,平野区,200686,95756,104930,84079,2006-03-01,03-01,2006
252,東住吉区,134434,63715,70719,60218,2006-03-01,03-01,2006
253,住吉区,159000,74841,84159,73047,2006-03-01,03-01,2006
254,阿倍野区,106983,49691,57292,47620,2006-03-01,03-01,2006
255,鶴見区,107589,52043,55546,42728,2006-03-01,03-01,2006
256,城東区,160796,76868,83928,71584,2006-03-01,03-01,2006
257,旭区,94809,45299,49510,43445,2006-03-01,03-01,2006
258,生野区,138079,65972,72107,61585,2006-03-01,03-01,2006
259,東成区,78959,37582,41377,36464,2006-03-01,03-01,2006
260,西成区,131714,77190,54524,78435,2006-03-01,03-01,2006
261,住之江区,130377,62674,67703,55019,2006-03-01,03-01,2006
262,淀川区,169550,83854,85696,85511,2006-03-01,03-01,2006
263,浪速区,54825,28023,26802,34835,2006-03-01,03-01,2006
264,西淀川区,95597,47249,48348,40910,2006-03-01,03-01,2006
265,大阪市,2629043,1279416,1349627,1248036,2006-03-01,03-01,2006
266,北区,101461,48844,52617,55804,2006-03-01,03-01,2006
267,福島区,61213,29017,32196,29875,2006-03-01,03-01,2006
268,此花区,63811,31037,32774,27934,2006-03-01,03-01,2006
269,都島区,99708,48478,51230,46540,2006-03-01,03-01,2006
270,西区,73356,34805,38551,42047,2006-03-01,03-01,2006
271,港区,83083,40653,42430,37837,2006-03-01,03-01,2006
272,大正区,73019,36022,36997,30993,2006-03-01,03-01,2006
273,天王寺区,64598,30048,34550,31227,2006-03-01,03-01,2006
274,中央区,67588,31293,36295,40900,2006-03-01,03-01,2006
275,東成区,79276,37737,41539,36961,2007-03-01,03-01,2007
276,生野区,136752,65345,71407,61781,2007-03-01,03-01,2007
277,旭区,94491,45160,49331,43679,2007-03-01,03-01,2007
278,城東区,161848,77366,84482,72662,2007-03-01,03-01,2007
279,鶴見区,107697,51989,55708,43057,2007-03-01,03-01,2007
280,住之江区,129652,62246,67406,55541,2007-03-01,03-01,2007
281,住吉区,157996,74320,83676,73113,2007-03-01,03-01,2007
282,東住吉区,133971,63498,70473,60437,2007-03-01,03-01,2007
283,平野区,200531,95612,104919,84673,2007-03-01,03-01,2007
284,東淀川区,177151,88105,89046,90051,2007-03-01,03-01,2007
285,阿倍野区,107069,49632,57437,48043,2007-03-01,03-01,2007
286,淀川区,170024,84013,86011,86668,2007-03-01,03-01,2007
287,西成区,128893,74974,53919,77366,2007-03-01,03-01,2007
288,浪速区,56758,28916,27842,36416,2007-03-01,03-01,2007
289,大阪市,2635379,1280487,1354892,1262936,2007-03-01,03-01,2007
290,北区,103251,49575,53676,57817,2007-03-01,03-01,2007
291,都島区,100769,48884,51885,47376,2007-03-01,03-01,2007
292,福島区,61849,29300,32549,30371,2007-03-01,03-01,2007
293,此花区,64272,31214,33058,28290,2007-03-01,03-01,2007
294,西淀川区,96426,47658,48768,41639,2007-03-01,03-01,2007
295,西区,75611,35782,39829,43175,2007-03-01,03-01,2007
296,港区,83880,41043,42837,38684,2007-03-01,03-01,2007
297,大正区,72329,35605,36724,30972,2007-03-01,03-01,2007
298,天王寺区,65076,30159,34917,31483,2007-03-01,03-01,2007
299,中央区,69807,32354,37453,42681,2007-03-01,03-01,2007
300,生野区,135772,64938,70834,62041,2008-03-01,03-01,2008
301,旭区,93987,44923,49064,43834,2008-03-01,03-01,2008
302,城東区,163601,78293,85308,73917,2008-03-01,03-01,2008
303,鶴見区,109605,52838,56767,44064,2008-03-01,03-01,2008
304,阿倍野区,107129,49600,57529,48464,2008-03-01,03-01,2008
305,住吉区,157174,73905,83269,73176,2008-03-01,03-01,2008
306,東住吉区,133251,63150,70101,60490,2008-03-01,03-01,2008
307,平野区,200393,95460,104933,85189,2008-03-01,03-01,2008
308,西成区,127154,74533,52621,74233,2008-03-01,03-01,2008
309,東成区,79213,37769,41444,37307,2008-03-01,03-01,2008
310,住之江区,128643,61768,66875,55794,2008-03-01,03-01,2008
311,東淀川区,177277,87949,89328,90867,2008-03-01,03-01,2008
312,淀川区,169795,83895,85900,87386,2008-03-01,03-01,2008
313,西淀川区,96716,47816,48900,42105,2008-03-01,03-01,2008
314,北区,104622,50208,54414,59307,2008-03-01,03-01,2008
315,都島区,101881,49320,52561,48438,2008-03-01,03-01,2008
316,福島区,63118,29904,33214,31407,2008-03-01,03-01,2008
317,此花区,64444,31333,33111,28556,2008-03-01,03-01,2008
318,中央区,71818,33511,38307,44170,2008-03-01,03-01,2008
319,大阪市,2643151,1284386,1358765,1275646,2008-03-01,03-01,2008
320,港区,84261,41292,42969,39347,2008-03-01,03-01,2008
321,大正区,71513,35215,36298,30884,2008-03-01,03-01,2008
322,天王寺区,66030,30553,35477,32188,2008-03-01,03-01,2008
323,浪速区,58100,29540,28560,38147,2008-03-01,03-01,2008
324,西区,77654,36673,40981,44335,2008-03-01,03-01,2008
325,生野区,134976,64550,70426,62186,2009-03-01,03-01,2009
326,旭区,93262,44587,48675,43781,2009-03-01,03-01,2009
327,城東区,165044,79034,86010,75050,2009-03-01,03-01,2009
328,鶴見区,110718,53266,57452,44721,2009-03-01,03-01,2009
329,阿倍野区,106980,49365,57615,48810,2009-03-01,03-01,2009
330,住吉区,156548,73634,82914,73370,2009-03-01,03-01,2009
331,東住吉区,132341,62688,69653,60310,2009-03-01,03-01,2009
332,平野区,200459,95440,105019,85785,2009-03-01,03-01,2009
333,西成区,125273,73567,51706,74465,2009-03-01,03-01,2009
334,東成区,79334,37922,41412,37772,2009-03-01,03-01,2009
335,住之江区,127635,61244,66391,55845,2009-03-01,03-01,2009
336,東淀川区,177185,87607,89578,91447,2009-03-01,03-01,2009
337,淀川区,170722,84366,86356,89043,2009-03-01,03-01,2009
338,西淀川区,96938,48016,48922,42671,2009-03-01,03-01,2009
339,北区,106606,51131,55475,61483,2009-03-01,03-01,2009
340,都島区,101638,49168,52470,48929,2009-03-01,03-01,2009
341,福島区,64923,30704,34219,32513,2009-03-01,03-01,2009
342,此花区,64808,31527,33281,28862,2009-03-01,03-01,2009
343,中央区,73889,34499,39390,45623,2009-03-01,03-01,2009
344,大阪市,2651781,1287847,1363934,1292153,2009-03-01,03-01,2009
345,港区,84635,41504,43131,39972,2009-03-01,03-01,2009
346,大正区,70875,34842,36033,30803,2009-03-01,03-01,2009
347,天王寺区,67480,31224,36256,33263,2009-03-01,03-01,2009
348,浪速区,59339,30102,29237,39671,2009-03-01,03-01,2009
349,西区,80173,37860,42313,45778,2009-03-01,03-01,2009
350,東成区,79846,38196,41650,38409,2010-03-01,03-01,2010
351,生野区,134379,64386,69993,62644,2010-03-01,03-01,2010
352,旭区,92583,44338,48245,43725,2010-03-01,03-01,2010
353,城東区,165751,79486,86265,75642,2010-03-01,03-01,2010
354,鶴見区,111094,53330,57764,45066,2010-03-01,03-01,2010
355,住之江区,127357,61160,66197,56311,2010-03-01,03-01,2010
356,住吉区,155879,73435,82444,73666,2010-03-01,03-01,2010
357,東住吉区,131232,62213,69019,60111,2010-03-01,03-01,2010
358,平野区,200223,95246,104977,86193,2010-03-01,03-01,2010
359,東淀川区,176691,87116,89575,91616,2010-03-01,03-01,2010
360,阿倍野区,106404,48994,57410,49007,2010-03-01,03-01,2010
361,西成区,123348,72579,50769,74648,2010-03-01,03-01,2010
362,淀川区,171891,85053,86838,90400,2010-03-01,03-01,2010
363,浪速区,60691,30789,29902,41248,2010-03-01,03-01,2010
364,西淀川区,97541,48343,49198,43436,2010-03-01,03-01,2010
365,大阪市,2660505,1292259,1368246,1307922,2010-03-01,03-01,2010
366,北区,108485,51895,56590,63416,2010-03-01,03-01,2010
367,福島区,66267,31366,34901,33568,2010-03-01,03-01,2010
368,此花区,65463,31891,33572,29322,2010-03-01,03-01,2010
369,都島区,102360,49446,52914,49689,2010-03-01,03-01,2010
370,西区,81694,38670,43024,46367,2010-03-01,03-01,2010
371,港区,85073,41788,43285,40579,2010-03-01,03-01,2010
372,大正区,70080,34430,35650,30691,2010-03-01,03-01,2010
373,天王寺区,69356,32084,37272,34344,2010-03-01,03-01,2010
374,中央区,76817,36025,40792,47824,2010-03-01,03-01,2010
375,生野区,133494,64055,69439,62811,2011-03-01,03-01,2011
376,旭区,92378,44233,48145,43775,2011-03-01,03-01,2011
377,城東区,165455,79314,86141,75752,2011-03-01,03-01,2011
378,鶴見区,111066,53211,57855,45175,2011-03-01,03-01,2011
379,阿倍野区,106187,48936,57251,49267,2011-03-01,03-01,2011
380,住吉区,155223,72969,82254,73680,2011-03-01,03-01,2011
381,東住吉区,130257,61648,68609,59744,2011-03-01,03-01,2011
382,平野区,199785,94912,104873,86634,2011-03-01,03-01,2011
383,西成区,121037,71219,49818,73961,2011-03-01,03-01,2011
384,東成区,80042,38323,41719,38780,2011-03-01,03-01,2011
385,住之江区,126955,60889,66066,56546,2011-03-01,03-01,2011
386,東淀川区,176215,86699,89516,91562,2011-03-01,03-01,2011
387,淀川区,171811,84927,86884,90922,2011-03-01,03-01,2011
388,西淀川区,97431,48276,49155,43401,2011-03-01,03-01,2011
389,北区,110952,53137,57815,65396,2011-03-01,03-01,2011
390,都島区,102852,49680,53172,50066,2011-03-01,03-01,2011
391,福島区,67554,31922,35632,34430,2011-03-01,03-01,2011
392,此花区,65654,32005,33649,29517,2011-03-01,03-01,2011
393,中央区,79108,37065,42043,49378,2011-03-01,03-01,2011
394,大阪市,2663098,1292432,1370666,1316626,2011-03-01,03-01,2011
395,港区,84719,41617,43102,40633,2011-03-01,03-01,2011
396,大正区,69169,33942,35227,30424,2011-03-01,03-01,2011
397,天王寺区,70027,32415,37612,34783,2011-03-01,03-01,2011
398,浪速区,62088,31501,30587,42687,2011-03-01,03-01,2011
399,西区,83639,39537,44102,47302,2011-03-01,03-01,2011
400,東成区,80520,38532,41988,39108,2012-03-01,03-01,2012
401,生野区,132459,63621,68838,62979,2012-03-01,03-01,2012
402,旭区,91988,44001,47987,43652,2012-03-01,03-01,2012
403,城東区,165060,79061,85999,75868,2012-03-01,03-01,2012
404,鶴見区,111414,53354,58060,45445,2012-03-01,03-01,2012
405,住之江区,126132,60486,65646,56570,2012-03-01,03-01,2012
406,住吉区,155126,72861,82265,73274,2012-03-01,03-01,2012
407,東住吉区,129160,61124,68036,59193,2012-03-01,03-01,2012
408,平野区,199276,94546,104730,87073,2012-03-01,03-01,2012
409,東淀川区,176608,86960,89648,92011,2012-03-01,03-01,2012
410,阿倍野区,106231,48875,57356,49462,2012-03-01,03-01,2012
411,淀川区,172405,85292,87113,91310,2012-03-01,03-01,2012
412,西成区,119211,69920,49291,73359,2012-03-01,03-01,2012
413,浪速区,63451,32201,31250,43390,2012-03-01,03-01,2012
414,大阪市,2668054,1294003,1374051,1324178,2012-03-01,03-01,2012
415,北区,113189,54301,58888,66998,2012-03-01,03-01,2012
416,都島区,103021,49697,53324,50267,2012-03-01,03-01,2012
417,福島区,69106,32665,36441,35324,2012-03-01,03-01,2012
418,此花区,66279,32312,33967,29852,2012-03-01,03-01,2012
419,西淀川区,97150,48039,49111,43300,2012-03-01,03-01,2012
420,西区,85202,40303,44899,48226,2012-03-01,03-01,2012
421,港区,83969,41142,42827,40539,2012-03-01,03-01,2012
422,大正区,68292,33454,34838,30183,2012-03-01,03-01,2012
423,天王寺区,71395,33109,38286,35558,2012-03-01,03-01,2012
424,中央区,81410,38147,43263,51237,2012-03-01,03-01,2012
425,鶴見区,111451,53373,58078,45661,2013-03-01,03-01,2013
426,生野区,131972,63341,68631,63100,2013-03-01,03-01,2013
427,旭区,91944,43970,47974,43679,2013-03-01,03-01,2013
428,城東区,164558,78685,85873,75699,2013-03-01,03-01,2013
429,阿倍野区,106363,48998,57365,49601,2013-03-01,03-01,2013
430,東成区,80569,38597,41972,39297,2013-03-01,03-01,2013
431,住吉区,154683,72518,82165,72745,2013-03-01,03-01,2013
432,東住吉区,128134,60636,67498,58637,2013-03-01,03-01,2013
433,平野区,198940,94377,104563,87586,2013-03-01,03-01,2013
434,西成区,117538,68797,48741,72586,2013-03-01,03-01,2013
435,住之江区,125603,60279,65324,56866,2013-03-01,03-01,2013
436,東淀川区,176854,87048,89806,92203,2013-03-01,03-01,2013
437,西区,86677,41004,45673,49003,2013-03-01,03-01,2013
438,西淀川区,96631,47663,48968,43196,2013-03-01,03-01,2013
439,北区,115162,55329,59833,68472,2013-03-01,03-01,2013
440,都島区,104169,50262,53907,50745,2013-03-01,03-01,2013
441,福島区,70413,33202,37211,36080,2013-03-01,03-01,2013
442,此花区,66574,32461,34113,30072,2013-03-01,03-01,2013
443,中央区,83703,39222,44481,52727,2013-03-01,03-01,2013
444,大阪市,2673891,1296296,1377595,1330970,2013-03-01,03-01,2013
445,港区,83206,40789,42417,40221,2013-03-01,03-01,2013
446,大正区,67336,32913,34423,29833,2013-03-01,03-01,2013
447,天王寺区,72869,33890,38979,36354,2013-03-01,03-01,2013
448,浪速区,65093,33064,32029,44511,2013-03-01,03-01,2013
449,淀川区,173449,85878,87571,92096,2013-03-01,03-01,2013
450,生野区,130928,62920,68008,63124,2014-03-01,03-01,2014
451,旭区,91770,43876,47894,43579,2014-03-01,03-01,2014
452,城東区,163719,78100,85619,75413,2014-03-01,03-01,2014
453,鶴見区,111413,53353,58060,45833,2014-03-01,03-01,2014
454,阿倍野区,107156,49408,57748,50002,2014-03-01,03-01,2014
455,住吉区,154077,72186,81891,72045,2014-03-01,03-01,2014
456,東住吉区,127289,60197,67092,58269,2014-03-01,03-01,2014
457,平野区,197814,93759,104055,87967,2014-03-01,03-01,2014
458,西成区,115247,67189,48058,71424,2014-03-01,03-01,2014
459,東成区,80479,38427,42052,39447,2014-03-01,03-01,2014
460,住之江区,124513,59755,64758,56880,2014-03-01,03-01,2014
461,東淀川区,176146,86710,89436,92083,2014-03-01,03-01,2014
462,淀川区,174153,86140,88013,92669,2014-03-01,03-01,2014
463,西淀川区,96016,47337,48679,42941,2014-03-01,03-01,2014
464,北区,118230,56932,61298,70330,2014-03-01,03-01,2014
465,都島区,104264,50249,54015,50937,2014-03-01,03-01,2014
466,福島区,71455,33789,37666,36783,2014-03-01,03-01,2014
467,此花区,66691,32570,34121,30323,2014-03-01,03-01,2014
468,中央区,86718,40574,46144,54805,2014-03-01,03-01,2014
469,大阪市,2675373,1296022,1379351,1336882,2014-03-01,03-01,2014
470,港区,82301,40315,41986,40081,2014-03-01,03-01,2014
471,大正区,66510,32483,34027,29578,2014-03-01,03-01,2014
472,天王寺区,73902,34379,39523,36979,2014-03-01,03-01,2014
473,浪速区,66499,33832,32667,45637,2014-03-01,03-01,2014
474,西区,88083,41542,46541,49753,2014-03-01,03-01,2014
475,東成区,80208,38321,41887,39392,2015-03-01,03-01,2015
476,生野区,130272,62746,67526,63370,2015-03-01,03-01,2015
477,旭区,91514,43727,47787,43598,2015-03-01,03-01,2015
478,城東区,164147,78255,85892,75888,2015-03-01,03-01,2015
479,鶴見区,111246,53257,57989,46013,2015-03-01,03-01,2015
480,住之江区,123594,59386,64208,56834,2015-03-01,03-01,2015
481,住吉区,153898,72010,81888,71689,2015-03-01,03-01,2015
482,東住吉区,126586,59804,66782,57879,2015-03-01,03-01,2015
483,平野区,197155,93368,103787,88566,2015-03-01,03-01,2015
484,東淀川区,175321,86201,89120,92096,2015-03-01,03-01,2015
485,阿倍野区,107362,49445,57917,50074,2015-03-01,03-01,2015
486,淀川区,174976,86571,88405,93260,2015-03-01,03-01,2015
487,西成区,113030,65507,47523,70078,2015-03-01,03-01,2015
488,浪速区,68103,34607,33496,46478,2015-03-01,03-01,2015
489,大阪市,2680203,1297433,1382770,1344580,2015-03-01,03-01,2015
490,北区,121320,58601,62719,72506,2015-03-01,03-01,2015
491,都島区,104487,50379,54108,51202,2015-03-01,03-01,2015
492,福島区,71886,33955,37931,37046,2015-03-01,03-01,2015
493,此花区,66504,32460,34044,30520,2015-03-01,03-01,2015
494,西淀川区,95457,47019,48438,42777,2015-03-01,03-01,2015
495,西区,90133,42518,47615,50806,2015-03-01,03-01,2015
496,港区,82179,40204,41975,40278,2015-03-01,03-01,2015
497,大正区,65574,31986,33588,29360,2015-03-01,03-01,2015
498,天王寺区,74968,34886,40082,37555,2015-03-01,03-01,2015
499,中央区,90283,42220,48063,57315,2015-03-01,03-01,2015
500,港区,81915,41869,40046,40349,2016-03-01,03-01,2016
501,大阪市,2692845,1389722,1303123,1358464,2016-03-01,03-01,2016
502,北区,124749,64419,60330,74812,2016-03-01,03-01,2016
503,都島区,104831,54251,50580,51743,2016-03-01,03-01,2016
504,福島区,72706,38452,34254,37664,2016-03-01,03-01,2016
505,此花区,66517,34017,32500,30752,2016-03-01,03-01,2016
506,中央区,93765,49926,43839,59559,2016-03-01,03-01,2016
507,西区,93275,49309,43966,52708,2016-03-01,03-01,2016
508,大正区,64828,33204,31624,29146,2016-03-01,03-01,2016
509,天王寺区,76390,40828,35562,38460,2016-03-01,03-01,2016
510,浪速区,70648,34762,35886,48172,2016-03-01,03-01,2016
511,淀川区,176210,88936,87274,94580,2016-03-01,03-01,2016
512,西淀川区,95357,48469,46888,42942,2016-03-01,03-01,2016
513,東成区,80507,41980,38527,39713,2016-03-01,03-01,2016
514,西成区,111267,46994,64273,68968,2016-03-01,03-01,2016
515,平野区,196336,103260,93076,89085,2016-03-01,03-01,2016
516,東住吉区,126138,66629,59509,57827,2016-03-01,03-01,2016
517,住吉区,153695,81926,71769,71506,2016-03-01,03-01,2016
518,東淀川区,175464,89067,86397,92865,2016-03-01,03-01,2016
519,阿倍野区,108063,58242,49821,50321,2016-03-01,03-01,2016
520,住之江区,122591,63667,58924,56979,2016-03-01,03-01,2016
521,城東区,164958,86380,78578,76760,2016-03-01,03-01,2016
522,旭区,91442,47814,43628,43573,2016-03-01,03-01,2016
523,生野区,129709,67240,62469,63590,2016-03-01,03-01,2016
524,鶴見区,111484,58081,53403,46390,2016-03-01,03-01,2016
